9999999999999999
9020000000100009
9000000000000009
9000000000000009
9020000000000A09
9000000010000A09
9000000000000B09
9000000000000B09
9000000000000009
9010000000000009
9000S00000000009
9000000000000019
9999999999999999