9999999999999999
9000000000200009
9000000000000009
9000100000000009
9000000000000009
9000000000000A09
9000000000000B09
9000000000000009
9000000000000D09
9000000000000009
9000000000000009
9000000000001009
9000S00000000009
9000000000000009
9999999999999999