999999999999999999999999999999999999999999999999999999999
9S0000000000000000000000000000000000000000000000000000009
900000000000000011111111111111111110000000000000000000009
900000000000000000000000000000000000000000000000000000009
900000000000000000000000000000000000000000000000000000009
900000000222222222222222222222222222222222220000000000009
900000000000000000000000000000000000000000000000000000009
900000000000000000000000000000000000000000000000000000009
900000000000000000000003333333000000000000000000000000009
900000000000000000000000000000000000000000000000000000009
900000000000000000000000000000000000000000000000000000009
900000000000000000000000000000000000000000000000000000009
900000000000000000000000000000000000000000000000000000009
900000000000000000000000000000000000000000000000000000009
900000000000000000000000000000000000000000000000000000009
900000000000000000000000000000000000000000000000000000009
900000000000000000000000000000000000000000000000000000009
900000000000000000000000000000000000000000000000000000009
900000000000000000000000000000000000000000000000000000009
90000A00000000000000000000B000000000000000C00000000000009
90000A00000000000000000000B000000000000000C00000000000009
90000A00000000000000000000B000000000000000C00000000000009
90000A00000000000000000000B000000000000000C00000000000009
900000000000000000000000000000000000000000000000000000009
999999999999999999999999999999999999999999999999999999999