999999999999999999999999999999999999999999999999999999999
900000000000000000000000000000000000000000000000000000009
900000010000000000000000000000000000000000000001000000009
900000000000000000000000000000000000000000000000000000009
900000000000000000000000000100000000000000000000001000009
900000000000000000000000000000000000000000000000000000009
900000000000000000000000000000000000000000000000000000009
900000000000000000000000000000000000000000000000000000009
900000000000000000000000000000000000000000000000000000009
900000000000000000000000000000000000000000000000000000009
900000000000000000000000000000000000000000000000000000009
900000000000000000000000000000000000000000000000000000009
900000000000000000000000000000000000000000000000000000009
900000000000000000000000000000000000000000000000000000019
90000000000000000000000000S001000000000000000000000000009
910000000000000000000000000000000000000000000000000000009
900000000000000000000000000000000000000000000000000000009
900000000000000000000000000000000000000000000000000000009
900000000000000000000000000000000000000000000000010000009
900000000000000000000000000000000000000000000000000000009
900000000000000000000000000000000000000000000000000000009
900000000000000000000000000000000000000000000000000000009
900000000000000000000000000000000000000000000000000000009
900000000000000000000000000000000000000000000000000000009
900000000000000000000000000000000000000000000000000000009
90000A0001000A0000000000000000000000100000000000000000009
90000A0000000A0000000000000000000000000000000000000000009
90000A0000000A0000000000000000000000000000000000000000009
90000AAAAAAAAA0000000000000000000000000000000001000000009
900000000000000000000100000000000000000000000000000000019
999999999999999999999999999999999999999999999999999999999



999999999999999999999999999999999999999999999999999999999
900000000000000000000000000000000000000000000000000000009
900000010000000000000000000000000000000000000001000000009
900000000000000000000000000000000000000000000000000000009
900000000000000000000000000100000000000000000000001000009
900000000000000000000000000000000000000000000000000000009
900000000000000000000000000000000000000000000000000000009
900000000000000000000000000000000000000000000000000000009
900000000000000000000000000000000000000000000000000000009
900000000000000000000000000000000000000000000000000000009
900000000000000000000000000000000000000000000000000000009
900000000000000000000000000000000000000000000000000000009
900000000000000000000000000000000000000000000000000000009
900000000000000000000000000000000000000000000000000000019
90000000000000000000000000S001000000000000000000000000009
910000000000000000000000000000000000000000000000000000009
900000000000000000000000000000000000000000000000000000009
900000000000000000000000000000000000000000000000000000009
900000000000000000000000000000000000000000000000010000009
900000000000000000000000000000000000000000000000000000009
900000000000000000000000000000000000000000000000000000009
900000000000000000000000000000000000000000000000000000009
90000000000000000000000000000000000000000000000R000000009
900000000000000000000000000000000000000000000000000000009
900000000000000000000000000000000000000000000000000000009
90000A0001000A0000000000000000000000100000000000000000009
90000A0000000A0000000000000000000000000000000000000000009
90000A0000000A0000000000000000000000000000000000000000009
90000AAAAAAAAA0000000000000000000000000000000001100000009
900000000000000000000100000000000000000000000000000000019
999999999999999999999999999999999999999999999999999999999