9999999999999999
9000000000000009
9000000000000009
9000100000000009
9000000000000009
9000000000000A09
9000000000000009
9000S00000000009
9000000000000009
9999999999999999